#.#X##.#.##.##..
.....X.X.....X..
........X.......
#.........a..X..
#...##..........
.....X..X...##..
AX.......#X###..
################
################
BX.......#X###..
.....X..X...##..
#...##..........
#.........b..X..
........X.......
.....X.X.....X..
#.#X##.#.##.##..
